111111111111111111111
100000000E00000000001
1000C0000000000000001
1000000000000000C0001
100000000000P00000001
111111111111111111111