11111111111111111111
100000000E0000000001
1000C000000000000001
1000000000000000C001
100000000000P0000001
11111111111111111111