111111111111
1P000000C001
10000C0000E1
111111111111