1111111111111
1P000000C0001
10000C0000E01
1111111111111